continent_britain = {
	1 2 3 4 5 6 7 8 9 10 11 12 13 14 15 16 17 18 19 20 21 22 23
	24 25 26 27 28 29 30 31 32 33 34 35 36 37 38 39 40 41 42 43
	44 45 46 47 48 49 50 51 52 53 54 55 56 57 58 59 60 63 66 67
	68 69 70 71 72 73 74 106 107 108 109 110 121 128 129 130 131
	132 133 136 137 138 139 140 142 143 144 146 147 148 151 152
	153 154 155 156 157 158 161 62 64 65 243 244 245 246 247 248
	249 250 252 253 254 255 256 257 258 261 262 265 266 315 316 
	317 318 319 320 321 322 328 329 330 331 332 333 334 335 336 
	337 338 339 340 341 342 343 344 345 346 347 348 349 350 351 
	352 353 354 355 356 357 358 359 360 361 362 363 364 365 448
	591 782 785 787 788 789 790 791 792 793 794 795 796 797 798 817 
	818 819 820 821 822 823 1100 1101 1102 1103 1104 1105 1106
	1107 1108 1109 1110 1111 1112 1113 1114 1115 1116 1117 1118
	1119 1120 1121 1122 1123 1124 1125 1126 1127 1128 1135 1136
	1137
}

continent_ireland = {
	89 90 91 92 93 94 95 96 97 98 99 100 101 102 103 104 105 111 
	112 113 114 115 116 117 118 119 120 134 135 145 251 267 268 
	269 270 271 272 273 274 275 276 277 278 279 931 932 933 934
	935 936 937 938 939 940 941 942 943 944 946 947 948 949
	950 951 952 953 954 955 956 957 958 959 960 961 962 963 964
	965 966 967 968 969 970 971 972 973 974 975 976 977 978 979
	980 981 982 983 984 985 986 987 988 989 990 991 992 993 994
	995
}

continent_europe = {
	75 76 77 78 79 80 81 82 83 84 85 86 87 88 122 123 124 125 126 127 149 150 159 160 
	162 163 164 165 166 167 168 169 170 171 172 173 174 175 176 177 178 179 180 181
	182 183 184 185 186 187 188 189 190 191 192 193 194 195 196 197 198 199 200 201
	202 203 204 205 206 207 208 209 210 211 212 213 214 215 216 217 218 219 220 221
	222 223 224 225 226 227 228 229 230 231 232 233 234 235 236 237 238 239 240 241
	242 414 415 416 417 418 419 420 421 422 423 424 425 426 427 428 429 430 431 432 
	433 434 435 436 437 438 439 440 441 442 443 444 445 446 447 449 450 451 452	453 
	454 455 456 457 458 459 460 461 462 463 464 465 466 467 468 469 470 471 477 478 
	479 480 481 482 483 484 485 486 487 488 489 490 491 492 493 494 495 498 499	500 
	501 502 503 504 505 506 518 519 520 521 522 523 524 525 526 527 528 529 530 531 
	532 533 534 535 536 537 538 539 540 541 542 543 544 545 546 548 549 550 551	552
	553 554 555 556 557 558 559 560 561 562 563 568 569 570 571 572 573 574 
	575 576 577 578 579 580 581 582 583 584 585 586 587 588 589 590 592 593 594 
	595 596 597 598 599 600 601 611 612 613 614 615 624 625 626 627 628 629 630 631 
	632 633 634 635 636 637 638 639 640 641 642 643 644 645 646 655 656 657 658 659 
	660 661 662 663 664 665 666 667 668 669 670 671 672 673 674 675 676 677 678 679 
	680 681 682 683 684 685 686 687 688 689 690 691 692 693 694 695 696 697 698 699 
	700 701 702 703 704 705 706 707 708 709 710 711 712 713 714 715 716 717 718	719 
	720 721 722 723 724 725 726 727 728 729 730 731 732 733 735 736 737 738 739	740 
	741 742 743 744 745 746 747 748 749 750 751 752 753 754 755 756 757 770 771 772 
	773 774 775 776 777 778 779 780 781 783 784 799 800 801 809 810 811 812 813 814 
	815 816 826 827 828 829 830 831 832 833 834 835 836 837 838 839 840 841 842 843 
	844 845 846 847 848 849 850 851 852 853 854 855 856 857 858 859 860 861 862 863 
	864 865 866 867 884 885 886 887 888 889 890 891 892 893 894 895 896 898 902 903
	904 905 906 907 908 909 910 911 912 913 914 915 916 919 920 921 922 923 924 925
	926 927 930 945 996 997 998 999 1000 1001 1002 1008 1009 1010 1011 1012 1013 1014
	1015 1016 1017 1018 1019 1020 1021 1022 1023 1024 1025 1026 1027 1028 1029 1030
	1031 1032 1033 1034 1035 1036 1037 1038 1039 1040 1041 1042 1043 1044 1045 1046
	1047 1048 1049 1050 1051 1052 1053 1054 1055 1056 1057 1058 1059 1060 1061 1062 1063
	1064 1065 1066 1067 1068 1069 1070 1071 1072 1073 1074 1075 1076 1077 1078 1079
	1080 1081 1082 1083 1084 1085 1086 1087 1088 1089 1090 1091 1092 1093 1094 1095
	1096 1097 1098 1099 1129 1130 1131 1132 1133 1134
}

continent_ynys_man = {
	61 141
}

continent_hebrides = {
	259 260
}

continent_shetland = {
	385 824
}

continent_hispania = {
	386
}

continent_lyonesse = {
	413
}

continent_gotland = {
	566 567 897
}