# Island regions - no land path from the continent
# The AI needs these to optimize path finding
#
# NOTE: do not add any regions here that are NOT islands

region_britain = {
	provinces = { 
		1 2 3 4 5 6 7 8 9 10 11 12 13 14 15 16 17 18 19 20 21 22 23
		24 25 26 27 28 29 30 31 32 33 34 35 36 37 38 39 40 41 42 43
		44 45 46 47 48 49 50 51 52 53 54 55 56 57 58 59 60 62 64 65
		63 66 67 68 69 70 71 72 73 74 106 107 108 109 110 121 128 
		129 130 131 132 133 136 137 138 139 140 142 143 144 146 147 
		148 151 152 153 154 155 156 157 158 161 243 244 245 246 247 248
		249 250 252 253 254 255 256 257 258 261 262 265 266 315 316 
		317 318 319 320 321 322 328 329 330 331 332 333 334 335 336 
		337 338 339 340 341 342 343 344 345 346 347 348 349 350 351 
		352 353 354 355 356 357 358 359 360 361 362 363 364 365 448
		591 597 671 782	785 786 787 788 789 790 791 792 793 794 795 796 797 798
		817 818 819 820 821 822 823 1100 1101 1102 1103 1104 1105 1106
		1107 1108 1109 1110 1111 1112 1113 1114 1115 1116 1117 1118
		1119 1120 1121 1122 1123 1124 1125 1126 1127 1128 1135 1136
		1137 1138 1143 1144 1145 1146 1147 1157 1158 1159 1160 1161
		1175 1176 1177 1178 1179 1180 1181 1182 1183 1184
	}
}

region_ireland = {
	provinces = { 
		89 90 91 92 93 94 95 96 97 98 99 100 101 102 103 104 105 111 112 113 114
		115 116 117 118 119 120 134 135 145 251 267 268 269 270 271 272 273 274 
		275 276 277 278 279 930 931 932 933 934 935 936 937 938 939 940 941 942
		943 944 946 947 948 949 950 951 952 953 954 955 956 957 958 959 960
		961 962 963 964 965 966 967 968 969 970 971 972 973 974 975 976 977 978
		979 980 981 982 983 984 985 986 987 988 989 990 991 992 993 994 995
	}
}

region_ynys_man = {
	provinces = { 61 141 }
}

region_hebrides = {
	provinces = { 
		259 260 1185 1186
	}
}

region_shetland = {
	provinces = { 
		385 824
	}
}

region_hispania = {
	provinces = {
		386 
	}
}

region_lyonesse = {
	provinces = { 
		413 
	}
}

region_gotland = {
	provinces = { 
		566 567 897
	}
}