#Example: Most of Europe north of med.
mild_winter = {
	# Ireland
	89 90 91 92 93 94 95 96 97 98 99 100 101 102 103 104 105 111 112 113 114 115 116 117 118 119 120 134 135 145 251 267 
	268 269 270 271 272 273 274 275 276 277 278 279 930 931 932 933 934 935 936 937 938 939 940 941 942 943 944 945 946
	947 948 949 950 951 952 953 954 955 956 957 958 959 960 961 962 963 964 965 966 967 968 969 970 971 972 973 974 975
	976 977 978 979 980 981 982 983 984 985 986 987 988 989 990 991 992 993 994 995
	# Southern Hen Ogledd
	37 38 39 40 41 42 43 55 56 57 61 107 108 130 131 136 138 147 148 158 315 316 317 790 791 792 793 795 796 797 798
	# Britannia
	1 2 3 4 5 6 7 8 9 10 11 12 13 14 15 16 17 18 19 20 21 22 23 24 25 26 27 28 29 30 31 32 33 34 35 36 44 45 46 47 48 49 
	50 51 52 53 54 58 59 60 74 106 121 132 133 137 142 143 146 151 152 153 154 155 156 157 328 329 330 331 332 333 334 335 
	336 337 338 339 340 341 342 343 344 345 346 347 348 349 350 351 352 353 354 355 356 357 358 359 360 361 362 363 364 365 
	413 591 782 785 786 787 788 789 794
	# Gaul
	75 76 77 78 79 80 81 82 83 84 85 86 87 88 122 123 124 125 126 127 149 150 159 160 162 163 164 165 166 167 168 169 170 171 172 173 174 175 176 177 178 179 180 181 182 183 184 185 186 187 188 189 190
	191 192 193 194 195 196 197 198 199 200 201 202 203 204 205 206 207 208 209 210 211 212 213 214 215 217 218 219 220 221 223 224 225 226 227 229 230 231 232 233 234 235 236 237 238 239 241 414 415 
	416 417 418 419 420 421	422 423 424 425 426 427 428 429 430 431 432 433 434 435 436 437 438 439 440 441 442 443 444 445 446 447 448 449 450 451 452 453 454 455 460 461 505 506 521 522 523 524 525
	548 549 550 551 552 554 555 588 589 590 592 593 594 596 597 598 599 600 614 624 625 627 628 629 630 631 632 633 634 635 636 637 638 639 640 641 642 643 644 645 646 655 656 657 658 659
	667 668 669 670 671 672 673 674 675 676 677 685 686 687 688 689 690 691 692 693 694 700 701 702 703 709 710 711 712 713 719 720 721 722 723 724 726 727 729 730 731 732 733 740 741 742 743
	745 746 749 751 752 753 754 755 756 757 799 800 801 809 810 811 812 813 814 815 816 902 903 904 905 906 907 910 912 913 914 915 916 919 921 922 923 924 925
	# Northern Hispania
	386
	# Saxony
	456 457 458 459 660 661 662 663 664 665 666 678 679 680 681 682 683 684 699 704 705 706 707 708 862 863 864 865 867 884 885 886 887 888 889 890 891 892 893
}

#Example: Inland Europe & Scandinavia
normal_winter = {
	# Alba
	62 63 64 65 66 73 128 129 243 244 245 246 247 248 249 250 252 253 254 255 256 257 258 259 260 261 262 263 264 265 266 384 385 817 818 819 820 821 822 823 824
	# Northern Hen Ogledd
	67 68 69 70 71 72 109 110 139 140 144 161 318 319 320 321 322
	# Burgundy and Auvergne
	216 222 228 240 242 595 601 626 695 696 697 698 714 715 716 717 718 735 736 737 738 739 996 998
	# Pyrenees
	744 747 748 750 908 909 911 920 926 927
	# Denmark
	477 478 479 480 481 482 483 484 485 486 487 488 489 490 491 492 493 494 495 498 499 500 501 502 518 519 520 556 557 558 559 560 561 562 563 618
	# Gotarland
	566 567 568 569 570 571 572 573 574 575 576 577 578 579 580 581 582 583 584 585 586 587 770 771 772 773 774 775 776 777 778 779 780 781 897
	# Angeln
	462 463 464 465 466 467 468 469 470 471 503 504 611 612 613 615 616 617 783 784
}

#Example: Russia & Lappland
severe_winter = {
	# Norway
	526 527 528 529 530 531 532 533 534 535 536 537 538 539 540 541 542 543 544 545 546 547 866 894 1008 1009 1010 1011 1012 1013 1014 1015 1016 1017 1018 1019 1020
	# Dal and Varmland
	553 826 827 828 829 830 831 832
	# Svealand
	833 834 835 836 837 838 839 840 841 842 843 844 845 846 847 848 849 850 851 852 853 854 855 856 857 858 859 860 861 895 896 898 1021 1022 1023
	# Alps
	725 728 997 999 1000 1001 1002
}
